id,clear_point,size,enemy0,enemy1
0,5,1,1,0
1,5,2,1,2
2,5,1,3,0
3,5,2,2,3
4,5,1,4,0
5,5,2,3,4
