id,0,1,2,3,4
0,0,0,2,0,1
1,0,0,2,3,4
2,0,2,4,2,1
3,0,4,2,1,4
4,1,4,3,1,3
5,2,1,2,3,4
