id,0,1,2,3,4
0,0,0,2,0,1
1,0,4,2,1,2
2,0,2,3,2,3
3,0,3,1,1,4
4,0,4,3,1,3
5,1,3,4,2,4
